56 36 
1 5 
0 0 0 0 0 0 0 0 0 0 0 0 0 0 0 0 0 0 0 0 0 0 0 0 0 0 0 0 0 0 0 0 0 0 0 0 0 0 0 0 0 0 0 0 0 0 0 0 0 0 0 0 0 0 0 0 
0 0 0 0 0 0 0 0 0 0 0 0 0 0 0 0 0 0 0 0 0 0 0 0 0 0 0 0 0 0 0 0 0 0 0 0 0 0 0 0 0 0 0 0 0 0 0 0 0 0 0 0 0 0 0 0 
0 0 0 0 0 0 0 0 0 0 0 0 0 0 0 0 0 0 0 0 0 0 0 0 0 0 0 0 0 0 0 0 0 0 0 0 0 0 0 0 0 0 0 0 0 0 0 0 0 0 0 0 0 0 0 0 
0 0 0 0 13 0 0 0 0 0 0 0 0 0 0 0 0 0 0 0 0 0 0 0 0 0 0 0 0 0 0 0 0 0 0 0 0 0 0 0 0 0 0 0 0 0 0 0 0 0 0 0 0 0 0 0 
0 0 0 0 0 0 0 0 0 0 0 0 0 0 0 0 0 0 0 0 0 0 0 0 0 0 0 0 0 0 0 0 0 0 0 0 0 0 0 0 0 0 0 0 0 0 0 0 0 0 0 0 0 0 0 0 
0 0 0 0 0 0 0 0 0 0 0 0 0 0 0 0 0 0 0 0 0 0 0 0 0 0 0 0 0 0 0 0 0 0 0 0 0 0 0 0 0 0 0 0 0 0 0 0 0 0 0 0 0 0 0 0 
0 0 0 0 0 0 0 0 0 0 0 0 0 0 0 0 0 0 0 0 0 0 0 0 0 0 0 0 0 0 0 0 0 0 0 0 0 0 0 0 0 0 0 0 0 0 0 0 0 0 0 0 0 0 0 0 
0 0 0 0 0 0 0 0 0 0 0 0 0 0 0 0 0 0 0 0 0 0 0 0 0 0 0 0 0 0 0 0 0 0 0 0 0 0 0 0 0 0 0 0 0 0 0 0 0 0 0 0 0 0 0 0 
0 0 0 0 0 0 0 0 0 0 0 0 0 0 0 0 0 0 0 0 0 0 0 0 0 0 0 0 0 0 0 0 0 0 0 0 0 0 0 0 0 0 0 0 0 0 0 0 0 0 0 0 0 0 0 0 
0 0 0 0 0 0 0 0 0 0 0 0 0 0 0 0 0 0 0 0 0 0 0 0 0 0 0 0 0 0 0 0 0 0 0 0 0 0 0 0 0 0 0 0 0 0 0 0 0 0 0 0 0 0 0 0 
0 0 0 0 0 0 0 0 0 0 0 0 0 0 0 0 0 0 0 0 0 0 0 0 0 0 0 0 0 0 0 0 0 0 0 0 0 0 0 0 0 0 0 0 0 0 0 0 0 0 0 0 0 0 0 0 
0 0 0 0 0 0 0 0 0 0 0 0 0 0 0 0 0 0 0 0 0 0 0 0 0 0 0 0 0 0 0 0 0 0 0 0 0 0 0 0 0 0 0 0 0 0 0 0 0 0 0 0 0 0 0 0 
0 0 0 0 0 19 0 0 0 0 0 0 0 0 0 0 0 0 0 0 0 0 0 0 0 0 0 0 0 0 0 0 0 0 0 0 0 0 0 0 0 0 0 0 0 0 0 0 0 0 0 0 0 0 0 0 
0 0 0 0 19 19 19 0 0 0 0 0 0 0 2 1 3 0 0 0 0 0 0 0 0 0 0 0 0 0 0 0 0 0 0 0 0 0 0 0 0 0 0 0 0 0 0 0 0 0 0 0 0 0 0 0 
0 0 0 0 13 18 0 0 0 0 0 0 0 0 7 4 8 0 0 0 0 0 0 0 0 0 0 0 0 0 0 0 0 0 0 0 0 0 0 0 0 0 0 0 0 0 0 0 0 0 0 0 0 0 0 0 
0 0 0 0 0 18 0 0 0 0 2 1 1 1 11 5 8 0 0 0 0 0 0 0 0 0 0 0 0 0 0 0 0 0 0 0 0 0 0 0 0 0 0 0 0 0 0 0 0 0 0 0 0 0 0 0 
0 0 0 0 0 18 0 0 0 0 7 5 6 4 5 6 8 0 0 0 0 0 0 0 0 0 0 0 0 0 0 0 0 0 0 0 0 0 0 0 0 0 0 0 0 0 0 0 0 0 0 0 0 0 0 0 
0 0 0 0 0 18 0 0 2 1 11 4 5 6 4 5 8 0 0 2 3 0 0 0 0 0 0 0 0 0 0 0 0 0 0 0 0 0 0 0 0 0 0 0 0 0 0 0 0 0 0 0 0 0 0 0 
1 1 1 13 13 1 1 1 11 4 4 5 6 4 5 6 12 1 1 11 22 20 20 13 13 13 13 13 13 13 13 13 13 13 13 13 13 1 1 1 1 1 1 1 1 1 1 1 1 1 1 1 1 1 1 1 
4 5 6 14 14 4 5 5 4 4 5 6 4 5 6 4 5 6 4 5 6 22 21 21 0 0 0 0 0 0 0 0 0 0 0 0 4 5 6 4 5 6 5 6 4 5 6 4 5 6 4 5 6 4 5 6 
4 5 6 14 14 4 5 5 4 4 5 6 4 5 6 4 5 6 4 5 6 4 21 21 0 0 0 0 0 0 0 0 0 0 0 6 4 5 6 4 5 6 5 6 4 5 6 4 5 6 4 5 6 4 5 6 
4 5 6 14 14 4 5 5 4 4 5 6 4 5 6 4 5 6 4 5 6 4 5 6 21 0 0 0 0 0 0 0 0 0 0 6 4 5 6 4 5 6 5 6 4 5 6 4 5 6 4 5 6 4 5 6 
4 5 6 14 14 4 5 5 4 4 5 6 4 5 6 4 5 6 4 5 6 4 5 6 4 21 0 0 0 0 0 0 0 0 5 6 4 5 6 4 5 6 5 6 4 5 6 4 5 6 4 5 6 4 5 6 
4 5 6 14 14 4 5 5 4 4 5 6 4 5 6 4 5 6 4 5 6 4 5 6 4 21 0 0 0 0 0 0 0 4 5 6 4 5 6 4 5 6 5 6 4 5 6 4 5 6 4 5 6 4 5 6 
4 5 6 14 14 4 5 5 4 4 5 6 4 5 6 4 5 6 4 5 6 4 5 6 4 5 6 21 0 0 0 5 6 4 5 6 4 5 6 4 5 6 5 6 4 5 6 4 5 6 4 5 6 4 5 6 
4 5 6 14 14 4 5 5 4 4 5 6 4 5 6 4 5 6 4 5 6 4 5 6 4 5 6 4 5 6 4 5 6 4 5 6 4 5 6 4 5 6 5 6 4 5 6 4 5 6 4 5 6 4 5 6 
4 5 6 14 14 4 5 5 4 4 5 6 4 5 6 4 5 6 4 5 6 4 5 6 4 5 6 4 5 6 4 5 6 4 5 6 4 5 6 4 5 6 5 6 4 5 6 4 5 6 4 5 6 4 5 6 
4 5 6 14 14 4 5 5 4 4 5 6 4 5 6 4 5 6 4 5 6 4 5 6 4 5 6 4 5 6 4 5 6 4 5 6 4 5 6 4 5 6 5 6 4 5 6 4 5 6 4 5 6 4 5 6 
4 5 6 14 14 4 5 5 4 4 5 6 4 5 6 4 5 6 4 5 6 4 5 6 4 5 6 4 5 6 4 5 6 4 5 6 4 5 6 4 5 6 5 6 4 5 6 4 5 6 4 5 6 4 5 6 
4 5 6 14 14 4 5 5 4 4 5 6 4 5 6 4 5 6 4 5 6 4 5 6 4 5 6 4 5 6 4 5 6 4 5 6 4 5 6 4 5 6 5 6 4 5 6 4 5 6 4 5 6 4 5 6 
4 5 6 14 14 4 5 5 4 4 5 6 4 5 6 4 5 6 4 5 6 4 5 6 4 5 6 4 5 6 4 5 6 4 5 6 4 5 6 4 5 6 5 6 4 5 6 4 5 6 4 5 6 4 5 6 
4 5 6 14 14 4 5 5 4 4 5 6 4 5 6 4 5 6 4 5 6 4 5 6 4 5 6 4 5 6 4 5 6 4 5 6 4 5 6 4 5 6 5 6 4 5 6 4 5 6 4 5 6 4 5 6 
4 5 6 14 14 4 5 5 4 4 5 6 4 5 6 4 5 6 4 5 6 4 5 6 4 5 6 4 5 6 4 5 6 4 5 6 4 5 6 4 5 6 5 6 4 5 6 4 5 6 4 5 6 4 5 6 
4 5 6 14 14 4 5 5 4 4 5 6 4 5 6 4 5 6 4 5 6 4 5 6 4 5 6 4 5 6 4 5 6 4 5 6 4 5 6 4 5 6 5 6 4 5 6 4 5 6 4 5 6 4 5 6 
4 5 6 14 14 4 5 5 4 4 5 6 4 5 6 4 5 6 4 5 6 4 5 6 4 5 6 4 5 6 4 5 6 4 5 6 4 5 6 4 5 6 5 6 4 5 6 4 5 6 4 5 6 4 5 6 
4 5 6 14 14 4 5 5 4 4 5 6 4 5 6 4 5 6 4 5 6 4 5 6 4 5 6 4 5 6 4 5 6 4 5 6 4 5 6 4 5 6 5 6 4 5 6 4 5 6 4 5 6 4 5 6 